1111111
1P000C1
1E0o001
1111111