1111111
11P00C1
1E10001
1111111