111111111111111111111111111111111111111111111111111111
100000000000000000000000000000000000000000000000000001
100000000000000000000000000000000000000000000000000001
10000000000000000000000000000000000000000000000P000001
100000000000000000000000000000000000000000000000000001
100000000000000000000000000000000000000000000000000001
100000000000000000000E00000000000000000000000000000001
100000000000000000000000000000000000000000000000000001
100000000000000000000000000000000000000000000000000001
100000000000000000000000000000000000000000000000000001
100000000000000C00000000000000000000000000000000000001
111111111111111111111111111111111111111111111111111111