11111111111111111111111111111111
1P010000000000000000010010010001
10010011110011111110010010011111
1B0000100100100100100000000CCB01
11111000011110010010011110011111
10010010010000010010000010000C01
10B10010010011110011110011110011
100000100B00000100100B000E010011
11111111111111111111111111111111