1111111111111111111111111111111111
1P01000000000000000001001001000001
1001001111001111111001001001111001
1B0000100100100100100000000CCB0001
1111100001111001001001111001111111
10010010010000010010000010000C0001
10B1001001001111001111001111001B01
100000100B00000100100B000E01001001
1111111111111111111111111111111111