1111111111111111111111111111111111111111111111111111111111111
1P01000000000000000001001001000000001000001000000000000001001
1001001111001111111001001001111001001001001111001111111001001
1000001001001001001000000000000001000001000001000000001000001
1111111001111001001001111001111111111001001001001111111111111
10010010010000010010010010000C0001000001001000000000001000001
1001001001001111001111001111001001111111001111111001001001001
1000001000000001001000000001001000001001001000000001000001001
1001001111111001001001001001001111111001111001111111001111111
100100000000000000100100100000000000000100000100000C000001001
1111111111111111001111001001001111001111001001111111111111001
1001001000B00001000001001001001000000001001001000000001000001
1001001111001001001111111001001111001111111111001111001001111
1000001000001001000001000001000001000000001000000001000000001
1111001001111111111001001001001111001111001111111111001001001
100000100000000000000000100100000100000100100100000B001001001
1111001001111111001111001111111001111111001001111111001001111
100000000100000100C001001001001000001001001000000000001000001
1001001001001111111001111001001111111001001001001111111001001
10010010000010000000010000000000000000000000010000000010010E1
1111111111111111111111111111111111111111111111111111111111111