1111111111111111111111111
1000000000000000000000001
1000000100000000000000001
10000001000000P0000000001
1000000100000000000000001
100000010000000000000E001
1000000100000000000000001
1000000100000000000000001
100000000000000C000000001
1111111111111111111111111