1111111
1P0B1C1
1B0E001
1111111