1111111
1P000C1
1B0E001
1111111