1111111
1P011C1
100E001
1111111