11111111111111111111111111111
10000P00000E0000C001111100000
11111111111111111111111111111