11111111111111111111111111111
10000P00000E0000C001111100001
11111111111111111111111111111