111111111111111
100000000000001
100000011100001
10000001P100001
1E00000111000C1
111111111111111