111111111111111
100000000000001
100000010000001
1P0000010000001
1E00000100000C1
111111111111111