111111111111111
100000000000001
100111000000001
1001E1000000001
100111000P00001
1000000000C0001
111111111111111