1111111
111P001
1E100C1
1111111