1111111
111P001
1C1E0C1
1111111