1111111
111P0C1
101ECC1
1111111