111111111111111
100000000000001
100000011100001
10000000P100011
1E10000111000C1
111111111111111