11111111111111
1000C000000C11
1E0C11111P0C11
11111111111111